Planning for Educational Game App.


Problem to solve/Purpose of App: Inform, Educate, Entertain.A

Target Market: High School Students

MVP: A pool of questions with accurate answers about the Capitals that the users can interact with. 

Additional features: Login Function.
                     HighScore saver

Scaling? Adding More subjects
         Augmenting the target segment. 
         Graphics (i.e. an interactive world map)
         Deploying to the web



HOW..


Plan of Attack: To work through the solution together. Openly communicating to understand the code


Hamish's list of countries and capitals:
Brazil - Brasilia
Spain - Madrid
United Kingdom - London
New Zealand - Auckland
Australia - Canberra
Austria - Vienna
Mexico - Mexico City
Slovakia - Bratislava 
Poland - Warsaw
Hungary - Budapest 


Ghalip's list of countries and capitals
Russia - Moscow, 
China - Beijing 
Turkey - Istanbul
Mongolia - Ulanbatur
East Turkistan - Urumqi 
Tibat - Lasa
Kazakistan - Almaty 
Uzbekistan - Tashkant 
  
